 C:\FPGA_Laboratory\Course_Project\Snake_Game\snake\snake\snake\docs\level.BMP(0)

0000000000000000000000000000000000000000000000000000000000000000;
0000000000000000000000000000000000000000000000000000000000000000;
0000000000000000000000000000000000000000000000000000000000000000;
0000000000000000000000000000000000000000000000000000000000000000;
0000000000000000000000000000000000000000000000000000000000000000;
0000000000000000000000000000000000000000000000000000000000000000;
0000000000000000000000000000000000000000000000000000000000000000;
0000000000000000000000000000000000000000000000000000000000000000;
0000000000000000000007F80007F83F000007F8000000000000000000000000;
000000000000F80003FFFFF803FFE3FC03FFFFF8007C00000000000000000000;
0000000001FFE000007FFFF8007FC1F8007FFFF8FFF000000000000000000000;
00000000001FC000003FFFF8007FE1F8003FFFF80FE000000000000000000000;
00000000001FC000001FF80C003FE1F8001FF80C0FE000000000000000000000;
00000000001FC000001FF044003FE3F0001FF0440FE000000000000000000000;
00000000001FC000001FF040003FE3F0001FF0400FE000000000000000000000;
00000000001FC000001FF3C0001FE3E0001FF3C00FE000000000000000000000;
00000000001FE000001FFFC0001FE3E0001FFFC00FF000000000000000000000;
00000000001FE020001FFFC0000FE7E0001FFFC00FF010000000000000000000;
00000000001FE020001FFFC0000FE7C0001FFFC00FF010000000000000000000;
00000000001FE020000FF8E0000FF7C0000FF8E00FF010000000000000000000;
00000000001FE060000FF0220007F780000FF0220FF030000000000000000000;
00000000001FF1F0000FF0220007FF80000FF0220FF8F8000000000000000000;
00000000001FF7F0000FF0060003FF00000FF0060FFBF8000000000000000000;
00000000001FFFF0000FE00C0003FF00000FE00C0FFFF8000000000000000000;
00000000003FFFF0000FFF0C0003FF00000FFF0C1FFFF8000000000000000000;
00000000003FFFF00007FFFC0001FE000007FFFC1FFFF8000000000000000000;
00000000003FFFF8003FFFFC0003FE00003FFFFC1FFFFC000000000000000000;
0000000000FFC00801FFFFFC0007FF0001FFFFFC7FE004000000000000000000;
0000000000000008020007FC00081FC0020007FC000004000000000000000000;
0000000000000000000000000000000000000000000000000000000000000000;
0000000000000000000000000000000000000000000000000000000000000000;
0000000000000000000000000000000000000000000000000000000000000000;/*C:\FPGA_Laboratory\Course_Project\Snake_Game\snake\snake\snake\docs\level.BMP0*/

